

C 94,104,128



NO 
./path_to_the_north_texture

   SO ./path_to_the_south_texture

WE ./path_to_the_west_texture

EA ./path_to_the_east_texture
F 254,91,113



111111111111111111111
100000000000000000001
100000000000000000001
100000000000000000001
100000000111000000001
100000000101000000001
100000000111000000001
100000000000000000001
1000000000N0000000001
111111111111111111111