

C 225,30,0



NO 
./path_to_the_north_texture

   SO ./path_to_the_south_texture

WE ./path_to_the_west_texture

EA ./path_to_the_east_texture
F 220,     100,056


 1111111111111111111111111111111111 111111111111111111111111111111
        1111111111111111111111111111111111011000001110000000000001 
        1000000000110000000000001111111111011000001110000000000001
111111111011000001110000000000001111111111011000001110000000000001
1001000E0000000000000000111111111111111111011000001110000000000001
111111111011000001110000000000001111111111011000001110000000000001
100000000011000001110111111111111111111111011000001110000000000001
111101111111110111000000100011111111110110000011100000000000011111
11110111111111011101010010001111111111011000001110000000000001
11000000110101011100000000000000000000000000001110000000000001
10000000000000001100000010001111111111011000001110000000000001
100000000000000011010100100011111111110110000011100000000000011
110000011101101111101111000111111111111011000001110000000000001
11110111 1110101 1011110100011111111110110000011100000000000011
11111111 1111111 111111111111111111111011000001110000000000001
111111111111111111111111111111111111111111111111111111111111111111