

C 181,101,29



NO 
./wall_yellow.png

   SO ./wall_green.png

WE ./wall_white.png

EA ./test.png
F 101,     67,33


11111111
10100001
10100001
10100001
10000001
10E00101
10000001
11111111