

C 225,30,0



NO 
./textures/wall_white.png

   SO ./textures/wall_yellow.png

WE ./textures/wall_purple.png

EA ./textures/wall_green.png
F 220,     100,056



11111111
10100001
10111101
1011 101
10011101
10N00101
10000001
11111111