

C 225,30,0



NO 
./textures/wall_yellow.png

   SO ./textures/wall_green.png

WE ./textures/wall_white.png

EA ./textures/pix.png
F 220,     100,056



111111111111111111111111111111111
111111111000000000110000000000001
111111111011000001110000000000001
1001000E0000000000000000111111111
111111111011000001110000000000001
100000000011000001110111111111111
11110111111111011100000010001
11110111111111011101010010001
11000000110101011100000010001
10000000000000001100000010001
10000000000000001101010010001
110000011101101111101101000111
11110111111101011101110010001
11111111111111111111110111111